0,6,0,1,0,0
2,0,3,0,4,0
5,2,5,1,0,0
0,0,0,3,2,0
0,1,0,1,0,0