2,3,5,0,2
1,6,3,2,0
0,0,2,4,2
1,1,0,0,4
4,3,6,5,1