2,1,4,2,0,5,0
2,3,0,0,4,3,1
0,2,0,0,1,1,1
5,4,3,3,1,0,6
6,5,3,2,0,0,0
0,0,3,2,0,6,1